============
=*    +    =
= +++   +  =
= +  ++ +F =
= +  +  +++=
= +        =
=     +    =
=+ +   +++ =
=+ +   + + =
=+++   + + =
=F        F=
============